NO maps/wolftex/pics/wood.xpm
SO maps/wolftex/pics/redbrick.xpm
WE maps/wolftex/pics/eagle.xpm
EA maps/wolftex/pics/mossy.xpm

F 220,100,0
C 50,50,80

1111111
1000001
100S001
1000001
1111111
